07
25
0
10
#######>########???####??
#.....m.m......#???#..#??
#.....m*m......#####..###
#.@...mmm....../........#
#...m.......$..#####....#
#..B...........#???#....#
################???######
